11111111111111111111111
1C00000000000000C000001
1000G0C000000000G000001
1000000000000000C000001
1E000000000000000000001
1000000000000000P000001
1000G000000000000000001
10000000000000000000001
1000C0000000000000G0001
10000000000C000000C0001
11111111111111111111111