11111111111111111111111
1C00000000000100C000001
1000G000000000000000001
1101110000111100C000001
1E000000001111000000001
1111111100011100P000001
1C000000000001000000001
10000000000001000000001
110111000011110000G0001
10000000000C000000C0001
11111111111111111111111
