111111111111111111111111111111111111
100000001000C00010000000000000000001
101110001000000010011111011111100001
101110001111011110010000000000100001
1000000000000000000100C0000100G000E1
101111111111011110010000000000100001
1010P1000000000010011111011111100001
1000010C0000000000000000000000000001
111111111111111111111111111111111111