11111111111111
11000000000001
10000000100001
11011100001111
10000000001111
11111111111111